###########################################################0
#++0000000000000000000000000##0000000000000000000000000==0#0
#0+++00000000000000000000000##000000000000000000000000=100#0
#++0000000000000000000000000##0000000000000000000000000==0#0
#000000000000000000000000000##000000000####000000000000000#0
#000000000000000000000000000##00000000000##000000000000000#0
#0000000000000000000000000000000000000000############00000#0
#0000000000000000000000000000000000000000##0000000=0=00000#0
#000000#######000000000000000000000000000##0000000=3=00000#0
#0000000000000000000000000000000000000000##00000000=000000#0
#0000000000000000000000000000000000000000##000000000000000#0
#0000000000000000##00000000000000000##000##000000000000000#0
#0000000000000000##00000000000000000##000000000##000000000#0
######00000000000##00000000000000000##000000000##000000000#0
######00000000000##00000000000000000##000000000##000000000#0
#0000000000000000##00000000000000000##000000000##000000000#0
#0000000000000000##00000000000000000####0000000##000000000#0
#000000000000000000000000000000000000000000000000000000000#0
#00000000000000000000000000000000000000000000000000000#####0
#00000000000000000000000000000000000000000##0000000000#####0
#000000######00000000000000000000000000000##00000000000000#0
#0000000000##00000000000000000000000000000##00000000000000#0
#0000000000##00000000000000000000000000000##00000000000000#0
#0000000000######000000000000000000#########00000000000000#0
#0000000000000000000000000000000000##000000000000000000000#0
#0000000000000==000000000000000000000000000000000000000000#0
#00=000000000004=00000000000000000000000000000000000000000#0
#0=2=0000000##==000000000000000000000000000000000000000000#0
#0=0=0000000##00000000000000000000000000000000000000000000#0
###########################################################0
